############
#....   ...#
#....   ...#
#..       .#
#.        .#
#..        #
#..    *   #
#      .   #
#  ...   * #
#. ### ### #
#.   # #R\ #
######L#####
