        ################
        #*****#!!  1   #
        #..\..#        #
#########\\\\ # .\\\.  #
#.............# *      #
#.. .\\\#..!..#\**     #
#.. LW\\#W  ..##### ####
#..R\\\\#.. ..*\*\*W...#
#.......A.. ...\.\...\\#
#..........     **     #
############....\.######
           #.....!#
           ########

Growth 10
Trampoline A targets 1
