#####L######
#....R....A#
#..........#
#\.  #@\ ..#
#\...#*  ###
#\.........#
#\..*.@....#
####@@.  ..#
#....#.. ###
#....#..**.#
#.1..#  .\\#
############

Trampoline A targets 1
