     ######
     #....#
     #.**.#
     #.**.#
     #.**.#
######.\\.######
#**....*.......#
#\\....L\\\....#
#A......*****..#
######R.....###########
     ###.....*.....\\\#
       #\\\\#..1...\\\#
       #\\\\#......\\\#
       ################

Trampoline A targets 1
