##############################
#R...........................#
#.........................W..#
#..\\\\\\\\\\\\\\\\\\\\\\\\..#
#............................#
#..*****.*\...*...*...*****..#
#..*\....*\....*\*..*.\\*\\..#
#..*\....****..!*!......*....#
#..*\....*\....*\*..*...*....#
#..*\....*\...*...*.....*....#
#............................#
#..\\\\\\\\\\\\\\\\\\\\\\\\..#
#................ ..... .....#
#................      W....L#
##############################

Growth 25
Razors 10
Flooding 20
